1111111111
1000000001
1010000101
1000000001
10000N0001
1000000001
1000100001
1010010101
1000000001
1111111111
