1111111111111111111
1001001001001000001
1011000001000001001
1001001001111101111
1001111000001001001
1000000000000001001
1001111111111001001
1111000000000001011
1000000001000000W01
1111111111111111111
