NO north

SO       south
EA east


WE west

C 1, 99,01
F -5, 100,   0
1011110111
1000000001
1010000101
1000000001
10000N0001
1000000001
1000100001
1010010101
1000000001
1011101111



















